1111111
10000E1
10P0001
10000C1
1111111