1111111111111111111

1P00100000000100C01
100E001010000C00001
1C00001001000100C01
1111111111111111111