111111111111111111111111111111111111111111111111111111111111
1P000000000000000000000000000000000000000000000C111111111111
100000000000000000000000000000000000000000000000111111111111
10000000000000000000000000000000000000000000000E111111111111
111111111111111111111111111111111111111111111111111111111111