1111111
1001EC1
10P1001
1111111