1111111
100011
1P0C11
1E0111
111111