1111111111111111111111111111111111111111111
1P111100000C111C0000C1111111111111111100C11
101111011111111101111111110C000C11111101111
10111101111111110111E1111101111111111101111
1011110111111111011101111101111111111101111
1000000000000000000000000000000000000000001
1111111111111111111111111111111111111111111