111111111
1P0010011
100E10001
1C0010011
111111111